44 20
100 100
2 2 2 2 2 2 2 2 2 2 2 2 2 2 2 2 2 2 2 2 5 5 5 5 5 5 5 5 5 5 5 5 5 5 5 5 5 5 5 5 5 5 5 5
2 3 3 3 3 3 3 3 3 3 3 3 3 3 3 3 3 3 3 2 5 5 2 2 2 2 2 2 2 2 2 2 2 2 2 2 2 2 2 2 2 2 2 5
2 3 3 3 3 3 3 3 3 3 3 3 3 3 3 3 3 3 3 2 5 5 2 4 4 4 4 4 4 4 4 4 4 4 4 4 4 4 4 4 4 4 2 5
2 3 3 3 3 3 3 3 3 3 3 3 3 3 3 3 3 3 3 2 5 5 2 4 4 4 4 4 4 4 4 4 4 4 4 4 4 4 4 4 4 4 2 5
2 3 3 3 3 3 3 3 3 3 3 3 3 3 3 3 3 3 3 2 5 5 2 4 4 4 4 4 4 4 4 4 4 4 4 4 4 4 4 4 4 4 2 5
2 3 3 3 3 3 3 3 3 3 3 3 3 3 3 3 3 3 3 2 5 5 2 4 4 4 4 4 4 4 4 4 4 4 4 4 4 4 4 4 4 4 2 5
2 3 3 3 3 3 3 3 3 3 3 3 3 3 3 3 3 3 3 2 5 5 2 4 4 4 4 4 4 4 4 4 4 4 4 4 4 4 4 4 4 4 2 5
2 3 3 3 3 3 3 3 3 3 3 3 3 3 3 3 3 3 3 2 5 5 2 4 4 4 4 4 4 4 4 4 4 4 4 4 4 4 4 4 4 4 2 5
2 3 3 3 3 3 3 3 3 3 3 3 3 3 3 3 3 3 3 4 4 4 4 4 4 4 4 4 4 4 4 4 4 4 4 4 4 4 4 4 4 4 2 5
2 3 3 3 3 3 3 3 3 3 3 3 3 3 3 3 3 3 3 4 4 4 4 4 4 4 4 4 4 4 4 4 4 4 4 4 4 4 4 4 4 4 2 5
2 3 3 3 3 3 3 3 3 3 3 3 3 3 3 3 3 3 3 2 5 5 2 4 4 4 4 4 4 4 4 4 4 4 4 4 4 4 4 4 4 4 2 5
2 3 3 3 3 3 3 3 3 3 3 3 3 3 3 3 3 3 3 2 5 5 2 4 4 4 4 4 4 4 4 4 4 4 4 4 4 4 4 4 4 4 2 5
2 3 3 3 3 3 3 3 3 3 3 3 3 3 3 3 3 3 3 2 5 5 2 4 4 4 4 4 4 4 4 4 4 4 4 4 4 4 4 4 4 4 2 5
2 3 3 3 3 3 3 3 3 3 3 3 3 3 3 3 3 3 3 2 5 5 2 4 4 4 4 4 4 4 4 4 4 4 4 4 4 4 4 4 4 4 2 5
2 3 3 3 3 3 3 3 3 3 3 3 3 3 3 3 3 3 3 2 5 5 2 4 4 4 4 4 4 4 4 4 4 4 4 4 4 4 4 4 4 4 2 2
2 3 3 3 3 3 3 3 3 3 3 3 3 3 3 3 3 3 3 2 5 5 2 4 4 4 4 4 4 4 4 4 4 4 4 4 4 4 4 4 4 4 4 5
2 3 3 3 3 3 3 3 3 3 3 3 3 3 3 3 3 3 3 2 5 5 2 4 4 4 4 4 4 4 4 4 4 4 4 4 4 4 4 4 4 4 4 5
2 3 3 3 3 3 3 3 3 3 3 3 3 3 3 3 3 3 3 2 5 5 2 4 4 4 4 4 4 4 4 4 4 4 4 4 4 4 4 4 4 4 2 2
2 3 3 3 3 3 3 3 3 3 3 3 3 3 3 3 3 3 3 2 5 5 2 2 2 2 2 2 2 2 2 2 2 2 2 2 2 2 2 2 2 2 2 5
2 2 2 2 2 2 2 2 2 2 2 2 2 2 2 2 2 2 2 2 5 5 5 5 5 5 5 5 5 5 5 5 5 5 5 5 5 5 5 5 5 5 5 5
