20 20
100 100
2 2 2 2 2 2 2 2 2 2 2 2 2 2 2 2 2 2 2 2
2 3 3 3 3 3 3 3 3 3 3 3 3 3 3 3 3 3 3 2 
2 3 3 3 3 3 3 3 3 3 3 3 3 3 3 3 3 3 3 2 
2 3 3 3 3 3 3 3 3 3 3 3 3 3 3 3 3 3 3 2 
2 3 3 3 3 3 3 3 3 3 3 3 3 3 3 3 3 3 3 2 
2 3 3 3 3 3 3 3 3 3 3 3 3 3 3 3 3 3 3 2 
2 3 3 3 3 3 3 3 3 3 3 3 3 3 3 3 3 3 3 2 
2 3 3 3 3 3 3 3 3 3 3 3 3 3 3 3 3 3 3 2 
2 3 3 3 3 3 3 3 3 3 3 3 3 3 3 3 3 3 3 2
2 3 3 3 3 3 3 3 3 3 3 3 3 3 3 3 3 3 3 2 
2 3 3 3 3 3 3 3 3 3 3 3 3 3 3 3 3 3 3 2 
2 3 3 3 3 3 3 3 3 3 3 3 3 3 3 3 3 3 3 2 
2 3 3 3 3 3 3 3 3 3 3 3 3 3 3 3 3 3 3 2 
2 3 3 3 3 3 3 3 3 3 3 3 3 3 3 3 3 3 3 2 
2 3 3 3 3 3 3 3 3 3 3 3 3 3 3 3 3 3 3 2 
2 3 3 3 3 3 3 3 3 3 3 3 3 3 3 3 3 3 3 2 
2 3 3 3 3 3 3 3 3 3 3 3 3 3 3 3 3 3 3 2 
2 3 3 3 3 3 3 3 3 3 3 3 3 3 3 3 3 3 3 2 
2 3 3 3 3 3 3 3 3 3 3 3 3 3 3 3 3 3 3 2 
2 2 2 2 2 2 2 2 2 2 2 2 2 2 2 2 2 2 2 2
